SSSSSSSSSSSSSSSSSSSSSSSSSSSSSSSSSSSSSSSSSSSSSSSSSSSSSSSSSSSSSSSSSSSSSSSSSSSSSSSSSSSSSSSSSSSSSSSSSSSS
S   S                                                                                              S
S   S                                                                                              S
S   S                                                                     T                        S
S   S                                                                   T     T                    S
S   S                                                                           T                  S
S   S        T               T         T                   T                                       S
S   S            P------      P-------        P-------         P------            T                S
S   S     S                                                                                        S
S   S                                                                                              S
S   S                                                                               T              S
S   S  S                                                                                           S
S   S                                                                                              S
S   S                                                                                              S
S   S     S                                                                                        S
S   S                                                                                 T            S
S   S                                                                                              S
S   S  S                                                                                           S
S   S                                                                                              S
S   S                                                                                              S
S   S     S                                                                            T           S
S   S                                                                                              S
S   S                                                                                              S
S    S                                                                                  T          S
S                                                                                                  S
S                                                                                                  S
S                                                                                                  S
SG----------- T           G----------- T          G----------  T           G-----------G-----------S
S            S                        S                       S                                    S
