#99CCFF
SSSSSSSSSSSSSSSSSSSSSSSSSSSSSSSSSSSSSSSSSSSSSSSSSSSSSSSSSSSSSSSSSSSSSSSSSSSSSSSSSSSSSSSSSSSSSSSSSS
S                                                                                                S
S                                                                                                S
S                                                                                                S
S                                                                                                S
S                                                              T      S    TE S                  S
S                                                                     SSSSSSSSS                  S
S                                                                              S                 S
S                                                      T                        S                S
S                                                    SSSSS                 B---  S               S
S                                 V                             T        SSSSSSSSSS              S
S                             SSSSSSSS                        SSSS                       T       S
S               E                               B---                                  SSSSS      S
S            S    T   S                       SSSSSSSSS                              S           S
S            SSSSSSSSSS             T                                 SSSS          S            S
S                                  SSSS                       T                    S             S
S                           T                              SSSSSSSS          SSSSSSSSSSSSSSSS    S
S                         SSSSS                                             S                 TT S
S                                                                          STTT   TTTTTTTTTTTTTTTS
S          E                            E            E          S   E   SSS     E                S
S                               S            S                SSSSSSSSSSSSSS                     S
SSSSSSSSSSSSSSSSSSSSSSSSSSSSSSSSSSSSSSSSSSSSSSSSSSSSSSSSSSSSSSSSSSSSSSSSSSSSSSSSSSSSSSSSSSSSSSSSSS
